# --- PARTIE 1 : NOMS DES PLANTES (Issu des JSON) ---
Menthe verte => Mentha spicata, Naanaa, نعناع, Menthe en épi, Menthe douce, Menthe marocaine
Romarin => Rosmarinus officinalis, Azir, أزير, Herbe aux couronnes, Encensier
Thym commun => Thymus vulgaris, Za'atar, زعتر, Farigoule, Thym cultivé
Basilic => Ocimum basilicum, Hbak, حبق, Herbe royale, Basilic commun
Persil => Petroselinum crispum, Ma'dnoos, معدنوس, Persil commun, Persil cultivé
Coriandre => Coriandrum sativum, Qasbour, قزبور, Kouzbar, كزبر, Persil arabe, Cilantro
Sauge officinale => Salvia officinalis, Salmia, سلمية, Sauge commune, Thé d'Europe
Lavande vraie => Lavandula angustifolia, Khzama, خزامى, Lavande officinale, Lavande fine, Lavande à feuilles étroites
Origan => Origanum vulgare, Zaatar, زعتر, Mardadouch, مردادوش, Marjolaine sauvage, Thym d'Espagne
Fenouil commun => Foeniculum vulgare, Basbas, بسباس, Nafaa, نافع, Fenouil officinal, Fenouil amer, Aneth doux, Fenouil sauvage
Verveine citronnelle => Aloysia citrodora, Louiza, لويزة, Verveine odorante, Verveine à feuilles de citron
Marjolaine => Origanum majorana, Mardadouch, مرددوش, Marjolaine des jardins, Thym de jardin
Anis vert => Pimpinella anisum, Nafeh, نافع, Habt hlawa, حبة حلاوة, Anis, Anis cultivé, Boucage anis
Cannelle de Ceylan => Cinnamomum verum, Qarfa, قرفة, Cannelle vraie, Cannelle officinale
Gingembre => Zingiber officinale, Skenjbir, سكينجبير, Gingembre officinal
Curcuma => Curcuma longa, Kharkoum, خرقوم, Safran des Indes, Turmeric
Cardamome verte => Elettaria cardamomum, Habb Hal, حب الهال, Qaqoulla, قاكولة, Vraie cardamome, Cardamome de Malabar, Cardamome aromatique
Giroflier => Syzygium aromaticum, Qronfel, قرنفل, Clou de girofle (pour les boutons floraux), Eugenia caryophyllata
Safran => Crocus sativus, Za'faran, زعفران, Safran cultivé, Safran d'automne
Laurier noble => Laurus nobilis, Rend, الرند, Laurier-sauce, Laurier vrai
Absinthe => Artemisia absinthium, Chiba, الشيبة, Grande absinthe, Armoise amère, Herbe aux vers
Camomille matricaire => Matricaria chamomilla, Babounj, بابونج, Camomille allemande, Camomille vraie, Camomille sauvage, Matricaire camomille
Armoise herbe blanche => Artemisia herba-alba Asso, Chih, الشيح, Absinthe blanche du désert, Armoise du désert
Nigelle cultivée => Nigella sativa, Sanouj, حبة البركة, سانوج, Cumin noir, Graine noire, Faux cumin, Poivrette
Réglisse => Glycyrrhiza glabra, Araq as-sūs, عرق السوس, Bois doux, Licorice
Rue officinale => Ruta graveolens, Fijel, فيجل, Sadab, سذاب, Rue des jardins, Herbe de grâce, Péganium
Mauve sylvestre => Malva sylvestris, Khobbiza, خبّيزة, Grande Mauve, Mauve des bois, Mauve sauvage, Faux géranium, Mauve officinale
Fenugrec => Trigonella foenum-graecum, Helba, الحلبة, Sénégrain
Ail => Allium sativum, Touma, ثومة, Ail commun, Ail cultivé
Eucalyptus commun => Eucalyptus globulus, Klitous, Kaliptos, أوكالبتوس, كليبتوس, Gommier bleu, Arbre à la fièvre
Grande ortie => Urtica dioica, Hriqa, حريقة, Ortie piquante, Ortie commune, Ortie vivace
Pissenlit => Taraxacum officinale, Hindiba, هندباء, Dent-de-lion, Florin d'or, Salade de taupe, Baraban, Cochet
Séné d'Alexandrie => Senna alexandrina, Sena, سنا, Séné de Tinnevelly, Séné de Khartum, Séné d'Égypte
Myrte commun => Myrtus communis, Rihane, ريحان, Mirs, مرس, Myrte juif, Myrte des jardins, Herbe du paradis, Nerte
Harmal => Peganum harmala, Harmel, الحرمل, Rue syrienne, Rue sauvage, Harmala
Chardon-Marie => Silybum marianum, Chouk al-jamal, شوك الجمل, Artichaut sauvage, Chardon argenté, Chardon Notre-Dame
Genévrier commun => Juniperus communis, Ar'ar, عرعر, Genévrier, Genévrier vulgaire
Carvi => Carum carvi, Karwiya, كروية, Cumin des prés, Anis des Vosges, Carvi officinal
Alchémille commune => Alchemilla vulgaris, Manteau de Notre-Dame, Pied-de-lion
Costus indien => Saussurea costus (Falc.) Lipsch., القسط الهندي, عود هندي, Costus amer, Racine de Costus, Qist al-Hindi
Rosier de Damas => Rosa × damascena, Ward Baladi, ورد بلدي, Rose de Damas, Rose de Castille
Jasmin commun => Jasminum officinale, Yasmin, ياسمين, Jasmin blanc, Jasmin poète
Laurier-rose => Nerium oleander, Difla, دفلة, Nérion, Oléandre
Hibiscus rose de Chine => Hibiscus rosa-sinensis, Hibiscus, هيبسكوس, الوردة الصينية, Rose de Chine, Faux-hibiscus
Bougainvillier spectaculaire => Bougainvillea spectabilis, Boughanfiliya, بوجانفيليا, Fleur de papier, Bougainvillée
Géranium rosat => Pelargonium graveolens, Atrach, عطرش, Géranium odorant, Pélargonium à forte odeur
Dattier => Phoenix dactylifera, Nakhla, تمر, Palmier dattier, Dattier commun
Cyprès commun => Cupressus sempervirens, Sarw, سرو, Cyprès méditerranéen, Cyprès d'Italie, Cyprès pyramidal, Cyprès toujours vert
Lantana => Lantana camara, Lantana, لانتانا, Verveine de Cunning, Corbeille d'or, Lantanier
Olivier commun => Olea europaea, Zitoune, زيتون, Olivier cultivé, Arbre à olives
Oranger amer => Citrus × aurantium L., Narenj, نارنج, Limon merr, ليمون مر, Bigaradier, Oranger de Séville, Oranger aigre, Chadeck
Arbousier => Arbutus unedo, Qatlab, قاتل أبيه, Arbre aux fraises
Caroubier => Ceratonia siliqua, Kharrûb, خروب, Pain de Saint-Jean, Figuier d'Égypte
Néflier commun => Mespilus germanica, Za'rour, زعرور, Néflier d'Allemagne
Cèdre de l'Atlas => Cedrus atlantica, Arz, أرز الأطلس, Cèdre bleu, Cèdre de l'Atlantique
Figuier commun => Ficus carica, Kermous, تين, شجرة التين, Figuier, Figuier comestible
Grenadier => Punica granatum, Rummân, رمان, Grenadier commun, Pomme de Carthage
Vigne cultivée => Vitis vinifera, Karma, كرمة, Inab, عنب, Vigne européenne, Vigne à vin, Raisin
Arganier => Argania spinosa, Argan, أركان, Tili, Tamat, Argan tree, Moroccan ironwood
Henné => Lawsonia inermis, Henna, الحناء, Arbre à henné, Mignonette égyptienne
Aloe vera => Aloe vera (L.) Burm.f., Sabbar, صبار, Aloès, Aloès des Barbades, Aloès vulgaire
Figuier de Barbarie => Opuntia ficus-indica, Kermouss el Hindi, كرموس الهندي, Hendiya, Nopal, Cactée raquette, Poire épineuse
Jujubier de Palestine => Ziziphus spina-christi, Sidr, السدر, Épine du Christ, Jujubier épineux, Pommier de Sidon
Coquelicot => Papaver rhoeas L., Ben Nouma, بنت النعاس, Khchkhach, خشخاش, Ponceau, Pavot-coq, Coq, Chaudron, Graza, Mahboula, Pavot-des-champs
Sésame => Sesamum indicum, Jeljlan, جلجلان, Gingelly, Benne
Amandier => Prunus dulcis, Louz, لوز, Amandier commun, Amandier à graines douces
Citronnier => Citrus limon, Laymoun, ليمون, Limoun hmad, ليمون حامض, Lemon Tree, Limon, Zitrone
Moringa => Moringa oleifera, Moringa, المورينجا, شجرة الحياة, Arbre de vie, Arbre à raifort
Carthame des teinturiers => Carthamus tinctorius, Guerṭem, قرطم, عصفر, Safran des teinturiers, Faux-safran
Souci officinal => Calendula officinalis, Souci, المَرْقَد, Souci des jardins, Souci commun
Lentisque => Pistacia lentiscus, Dhrou, ضرو, Arbre à mastic, Mastic tree
Bissap => Hibiscus sabdariffa, Karkadé, كركديه, Roselle, Oseille de Guinée, Fleur de Jamaïque
Lin cultivé => Linum usitatissimum, Kettane, كتان, Lin commun, Lin oléagineux
Ricin => Ricinus communis, Kharwaa, الخروع, Ricin commun, Palma Christi
Menthe pouliot => Mentha pulegium L., Fliou, فلّيو, Ghleou, Pouliot, Menthe sauvage, Menthe à pouliot

# --- PARTIE 2 : CONCEPTS & SYMPTOMES (Généré par Gemini) ---
Mi-ombre => ombre partielle, mi-soleil, peu de soleil, clarté, nuss-del, نص ضل, protection solaire, manque de lumière
Faible => peu d'eau, sec, rarement, parcimonieux, chwiya lma, شوية الما, ma bzafch, ما بزافش, déshydratation, flétrissement
Sol bien drainé, calcaire, voire pauvre => terre aérée, terre filtrante, ne retient pas l'eau, terre sèche, terre méditerranéenne, terre maigre, terba mssarfa, تراب مسرف, terba kayssa, تراب قايس, terba na9sa, تراب ناقص, pourriture des racines, excès d'eau, carence nutritive
Épice => assaisonnement, aromate, condiment, saveur, 3atriya, عطرية, tbilat, تتبيلة, cuisine, goût
Tout type de sol, préfère drainé => adaptable, polyvalent, terre facile, supporte tout, terre aérée, ayy terba, أي تراب, terba mssarfa, تراب مسرف, flexibilité, tolérance
Bien drainé, riche en matière organique => terre humifère, terre fertile, terre vivante, terre de jardin, terreau, aérée, terba mssarfa, تراب مسرف, terba ghniya, تراب غني, croissance saine, pourriture racinaire
Bien drainé, sablonneux, léger => terre de sable, terre aérée, terre légère, terre filtrante, ne retient pas l'eau, terba mssarfa, تراب مسرف, terba rmliya, تراب رملي, séchage rapide, racines aériennes
Aromatique => parfumée, odorante, senteur, fragrance, herbe culinaire, épice, 3atriya, عطرية, ri7a zwina, ريحة زوينة, cuisine, tisane, parfum
Infusion => tisane, boisson chaude, thé, décoction, macération, atay, أتاي, tizan, تيزانة, relaxation, digestion, maux de tête
Anti-inflammatoire => réduit l'inflammation, calme la douleur, soulage, contre les gonflements, ddwa l'l-7riq, دوا للحريق, ddwa l'intiifa7, دوا للانتفاخ, douleur, gonflement, rougeur, courbatures, arthrite
Sol bien drainé, sec à frais, calcaire => terre aérée, ne retient pas l'eau, terre sèche, terre méditerranéenne, terre calcaire, terba mssarfa, تراب مسرف, terba nachfa, تراب ناشف, terba kayssa, تراب قايس, pourriture racinaire, chlorose
Dessert => douceur, fin de repas, gourmandise, pâtisserie, 7lawi, حلوي, discert, ديسير, plaisir gustatif, envie de sucre
Salade => crudités, accompagnement, frais, feuilles, légumes crus, salada, سلطة, repas léger, vitamines, fibres
Léger, bien drainé, riche en humus => terre fertile, terreau, terre aérée, terre de sous-bois, terba khfifa, تراب خفيف, terba mssarfa, تراب مسرف, terba ghniya, تراب غني, bonne croissance, santé racinaire
Respiratoire => voies respiratoires, poumons, bronches, expectorant, décongestionnant, nfs, نفس, ddwa l'l-berd, دوا للبرد, toux, rhume, asthme, bronchite, maux de gorge
Riche, bien drainé, légèrement acide à neutre => terre fertile, terreau, terre saine, terre de bruyère, terre aérée, terba ghniya, تراب غني, terba mssarfa, تراب مسرف, terba 7amda, تراب حامض, bonne croissance, jaunissement
Profond, bien drainé, argilo-sableux => terre en profondeur, terre équilibrée, terre lourde, terba 3ami9a, تراب عميق, terba mssarfa, تراب مسرف, terba tiliya, تراب طيني, racines profondes, ancrage
Bien drainé, préfère les sols argileux ou calcaires => terre aérée, terre lourde, terre méditerranéenne, terba mssarfa, تراب مسرف, terba tiliya, تراب طيني, terba kayssa, تراب قايس, pourriture racinaire, chlorose
Sec, calcaire et bien drainé => terre aride, terre sèche, rocaille, terre méditerranéenne, terba nachfa, تراب ناشف, terba kayssa, تراب قايس, terba mssarfa, تراب مسرف, dessèchement, stress hydrique
Digestif => estomac, intestins, maux de ventre, ballonnements, nausées, transit, l-hdam, الهضم, lkrouch, الكروش, indigestion, brûlures d'estomac, crampes
Tout type de sol bien drainé => adaptable, polyvalent, terre facile, terre aérée, ayy terba, أي تراب, terba mssarfa, تراب مسرف, tolérance, flexibilité
Bien drainé, fertile => terre riche, terreau, terre productive, terre vivante, terba mssarfa, تراب مسرف, terba ghniya, تراب غني, croissance vigoureuse, bonne récolte
Couvre-sol => tapissant, rampante, protège le sol, limite les mauvaises herbes, végétalisation, kayghatti l'erd, كيغطي الأرض, nabat frachi, نبات فراشي, érosion, mauvaises herbes
Tout type de sol bien drainé et riche => adaptable, polyvalent, terre facile et fertile, terreau, terre aérée, ayy terba, أي تراب, terba mssarfa, تراب مسرف, terba ghniya, تراب غني, croissance saine
Apaisant => calmant, relaxant, tranquillisant, anxiolytique, m-hadde', مهدئ, kay-henni, كيهني, stress, anxiété, insomnie, nervosité
Tonique => énergisant, stimulant, fortifiant, revitalisant, coup de fouet, moqawwi, مقوي, kay-qowwi, كيقوي, fatigue, faiblesse, convalescence, vitalité
Tout sol bien drainé, préfère les sols légers et légèrement calcaires. => adaptable, polyvalent, terre facile, terre aérée, terre légère, terba khfifa, تراب خفيف, terba mssarfa, تراب مسرف, terba kayssa, تراب قايس, tolérance, terre méditerranéenne
Tout type de sol, bien drainé, préférence calcaire => adaptable, polyvalent, terre facile, terre aérée, terre méditerranéenne, terba kayssa, تراب قايس, terba mssarfa, تراب مسرف, chlorose, sol alcalin
Calcaire ou siliceux, bien drainé => terre méditerranéenne, terre aérée, terre filtrante, terre basique, terre acide, terba kayssa, تراب قايس, terba 7amda, تراب حامض, terba mssarfa, تراب مسرف, chlorose, carences
Riche, humide et bien drainé => terre fertile, terreau, terre fraîche, terre aérée, ne s'assèche pas, terba ghniya, تراب غني, terba fziga, تراب فزك, terba mssarfa, تراب مسرف, croissance vigoureuse, pourriture racinaire
Bien drainé, acide à neutre => terre aérée, terre de bruyère, terre de sous-bois, terre non calcaire, terba mssarfa, تراب مسرف, terba 7amda, تراب حامض, jaunissement, chlorose
Léger, bien drainé, sablonneux => terre aérée, terre de sable, terre filtrante, terre perméable, terba khfifa, تراب خفيف, terba mssarfa, تراب مسرف, terba rmliya, تراب رملي, séchage rapide, racines fines
Fréquent => souvent, régulièrement, beaucoup d'eau, terre humide, bzaf lma, بزاف الما, dima lma, ديما الما, dessèchement, stress hydrique, soif
Tout type de sol bien drainé, riche en nutriments => adaptable, polyvalent, terre facile et fertile, terreau, terre aérée, ayy terba, أي تراب, terba mssarfa, تراب مسرف, terba ghniya, تراب غني, croissance saine
Riche, Bien drainé => terre fertile, terreau, terre aérée, bonne terre, productive, terba ghniya, تراب غني, terba mssarfa, تراب مسرف, croissance saine
Sols légers et bien drainés => terre aérée, terre filtrante, terre perméable, terre facile, terba khfifa, تراب خفيف, terba mssarfa, تراب مسرف, séchage rapide
Bien drainé, léger, calcaire => terre méditerranéenne, terre aérée, terre filtrante, terre perméable, terba mssarfa, تراب مسرف, terba khfifa, تراب خفيف, terba kayssa, تراب قايس, séchage rapide, chlorose
Modéré => moyen, ni trop ni pas assez, régulièrement, normalement, m-tewassit, متوسط, qadd qadd, قد قد, stress hydrique, pourriture racinaire
Sec, calcaire, bien drainé => terre aride, terre méditerranéenne, rocaille, terre pauvre, terba nachfa, تراب ناشف, terba kayssa, تراب قايس, terba mssarfa, تراب مسرف, dessèchement, stress hydrique
Bien drainé, calcaire, sec => terre aride, terre méditerranéenne, rocaille, terre pauvre, terba mssarfa, تراب مسرف, terba kayssa, تراب قايس, terba nachfa, تراب ناشف, dessèchement, stress hydrique
Jardin sec => rocaille, jardin méditerranéen, xeriscape, jardin sans arrosage, jnan nachaf, جنان ناشف, jnan bla ma, جنان بلا ما, sécheresse, économie d'eau
Sec, sableux, rocheux, bien drainé => terre aride, rocaille, terre de sable, terre pauvre, terba nachfa, تراب ناشف, terba rmliya, تراب رملي, terba 7jriya, تراب حجرية, terba mssarfa, تراب مسرف, dessèchement, stress hydrique
Balcon => pot, jardinière, conteneur, terrasse, petit espace extérieur, balcon, بالكون, f's-sṭa7, ف السطح, espace limité, arrosage fréquent
Humide, riche, bien drainé => terre fraîche, terreau, terre fertile, terre aérée, ne s'assèche pas, terba fziga, تراب فزك, terba ghniya, تراب غني, terba mssarfa, تراب مسرف, croissance vigoureuse, pourriture racinaire
Bien drainé, sableux ou limoneux, tolérant aux sols pauvres et calcaires => adaptable, polyvalent, terre facile, terre de sable, terba mssarfa, تراب مسرف, terba rmliya, تراب رملي, terba na9sa, تراب ناقص, terba kayssa, تراب قايس, tolérance, robustesse
Sols variés, calcaires et bien drainés => adaptable, polyvalent, terre aérée, terre méditerranéenne, terba mkhaltat, تراب مخلط, terba kayssa, تراب قايس, terba mssarfa, تراب مسرف, tolérance, flexibilité
Préfère un sol bien drainé, léger et calcaire. => terre méditerranéenne, terre aérée, terre filtrante, terre alcaline, terba mssarfa, تراب مسرف, terba khfifa, تراب خفيف, terba kayssa, تراب قايس, séchage rapide, chlorose
Bien drainé, léger, riche => terre fertile, terreau, terre aérée, terre facile, productive, terba mssarfa, تراب مسرف, terba khfifa, تراب خفيف, terba ghniya, تراب غني, croissance saine
Bien drainé, sableux à argileux => terre équilibrée, terre aérée, terre de sable, terre argileuse, terba mssarfa, تراب مسرف, terba rmliya, تراب رملي, terba tiliya, تراب طيني, perméabilité, rétention d'eau
Dermatologique => peau, épiderme, problèmes de peau, acné, eczéma, coupures, brûlures, ddwa l'l-jeld, دوا للجلد, l-jeld, الجلد, démangeaisons, irritations, blessures
Sol léger, limono-sableux, riche en humus, bien drainé => terre fertile, terreau, terre aérée, terre équilibrée, terba khfifa, تراب خفيف, terba ghniya, تراب غني, terba mssarfa, تراب مسرف, croissance saine, bonne structure
Intérieur => plante d'appartement, plante de maison, pot, f'd-dar, ف الدار, nabat d'd-dar, نبات الدار, manque de lumière, air sec, courant d'air
Drainé, sablonneux, calcaire, pauvre => terre aérée, terre de sable, terre méditerranéenne, terre aride, terba mssarfa, تراب مسرف, terba rmliya, تراب رملي, terba kayssa, تراب قايس, terba na9sa, تراب ناقص, dessèchement, carences
Riche, bien drainé => terre fertile, terreau, terre aérée, bonne terre, productive, terba ghniya, تراب غني, terba mssarfa, تراب مسرف, croissance saine
Tout type de sol bien drainé, préfère calcaire => adaptable, polyvalent, terre facile, terre aérée, terre méditerranéenne, terba kayssa, تراب قايس, terba mssarfa, تراب مسرف, chlorose, sol alcalin
Haie => clôture végétale, brise-vue, limite, bordure, arbuste, séparation, 7ayt khder, حيط خضر, ssur, صور, intimité, protection contre le vent
Sols profonds, sableux, bien drainés, tolère la salinité => terre de bord de mer, terre profonde, terre aérée, terre de sable, terba 3ami9a, تراب عميق, terba rmliya, تراب رملي, terba mssarfa, تراب مسرف, terba m-mal7a, تراب مالح, stress salin, bord de mer
Antiseptique => désinfectant, antibactérien, antimicrobien, cicatrisant, mo3aqqim, معقم, ddwa l'l-jro7, دوا للجروح, infections, plaies, coupures, brûlures
Bien drainé, Riche => terre fertile, terreau, terre aérée, bonne terre, productive, terba ghniya, تراب غني, terba mssarfa, تراب مسرف, croissance saine
Bien drainé, Léger à calcaire => terre aérée, terre filtrante, terre méditerranéenne, terre alcaline, terba mssarfa, تراب مسرف, terba khfifa, تراب خفيف, terba kayssa, تراب قايس, séchage rapide, chlorose
Sol léger et bien drainé => terre aérée, terre filtrante, terre perméable, terre facile, terba khfifa, تراب خفيف, terba mssarfa, تراب مسرف, séchage rapide
Riche, frais et bien drainé => terre fertile, terreau, terre aérée, terre vivante, terba ghniya, تراب غني, terba barida, تراب بارد, terba mssarfa, تراب مسرف, croissance vigoureuse, pourriture racinaire
Fleurs coupées => bouquet, décoration florale, vase, fleuriste, ornemental, wrid, وريد, zhar l-qtif, زهر القطيف, esthétique, événement
Plein soleil => forte lumière, exposition directe, chaleur intense, aridité, chams, شمس, chams bzaf, شمس بزاف, brûlures des feuilles, dessèchement rapide
Frais, riche en humus, bien drainé => terre fertile, terreau, terre aérée, terre de sous-bois, terba barida, تراب بارد, terba ghniya, تراب غني, terba mssarfa, تراب مسرف, croissance saine, bonne santé des racines
Aride, sablonneux, calcaire, bien drainé => désertique, sec, rocailleux, terre de sable, terre méditerranéenne, terba qas7a, تراب قاصح, terba rmliya, تراب رملي, terba kayssa, تراب قايس, terba nachfa, تراب ناشف, terba mssarfa, تراب مسرف, sécheresse, stress hydrique
Bien drainé et fertile => terre riche, terreau, terre productive, terre vivante, terba mssarfa, تراب مسرف, terba ghniya, تراب غني, croissance vigoureuse, bonne récolte
Drainé, riche, sableux-limoneux => terre fertile, terreau, terre aérée, terre équilibrée, terba mssarfa, تراب مسرف, terba ghniya, تراب غني, terba rmliya, تراب رملي, croissance saine, bonne structure
Riche, bien drainé, humifère => terre fertile, terreau, terre aérée, terre vivante, terre de sous-bois, terba ghniya, تراب غني, terba mssarfa, تراب مسرف, croissance saine
Sols légers, bien drainés et calcaires => terre méditerranéenne, terre aérée, terre filtrante, terre alcaline, terba khfifa, تراب خفيف, terba mssarfa, تراب مسرف, terba kayssa, تراب قايس, séchage rapide, chlorose
Bien drainé => terre aérée, filtrante, perméable, ne retient pas l'eau, sol léger, terba mssarfa, تراب مسرف, terba kay-ssarf lma, تراب كيسرف الما, pourriture racinaire, excès d'eau
Bien drainé, sablonneux à limoneux => terre équilibrée, terre aérée, terre de sable, terre filtrante, terba mssarfa, تراب مسرف, terba rmliya, تراب رملي, perméabilité, rétention d'eau
Jardin => extérieur, pleine terre, espace vert, parterre, massif, cour, jnan, جنان, aménagement paysager
Léger, bien drainé, riche en matière organique => terre fertile, terreau, terre aérée, terre de sous-bois, terba khfifa, تراب خفيف, terba mssarfa, تراب مسرف, terba ghniya, تراب غني, bonne croissance, santé racinaire
Riche, humifère, bien drainé => terre fertile, terreau, terre aérée, terre vivante, terre de sous-bois, terba ghniya, تراب غني, terba mssarfa, تراب مسرف, croissance saine
Riche, humide, profond, bien drainé => terre fertile, terreau, terre fraîche, terre aérée, terre en profondeur, terba ghniya, تراب غني, terba fziga, تراب فزك, terba 3ami9a, تراب عميق, terba mssarfa, تراب مسرف, croissance vigoureuse, pourriture racinaire
Sec, rocailleux, pauvre, bien drainé => terre aride, rocaille, terre méditerranéenne, terre de montagne, terre maigre, terba nachfa, تراب ناشف, terba 7jriya, تراب حجرية, terba na9sa, تراب ناقص, terba mssarfa, تراب مسرف, sécheresse, carences
Cuit => cuisine, cuisson, bouilli, rôti, grillé, poêlé, transformé, tayeb, طايب, mtayeb, مطيب, digestion, toxicité (si cru)
Bien drainé, tolère divers sols => adaptable, polyvalent, terre facile, supporte tout type de terre, terba mssarfa, تراب مسرف, ayy terba, أي تراب, kay-tsaber, كيتصبر, tolérance, robustesse
Bien drainé, supporte calcaire et acide => adaptable, polyvalent, terre aérée, terre filtrante, supporte pH variable, terba mssarfa, تراب مسرف, terba kayssa, تراب قايس, terba 7amda, تراب حامض, tolérance
Autre usage médical => remède, traitement, phytothérapie, médecine douce, pharmacie naturelle, ddwa, دوا, dawi, داوي, maladie, trouble, bien-être, guérison
Riche et bien drainé => terre fertile, terreau, terre aérée, bonne terre, productive, terba ghniya, تراب غني, terba mssarfa, تراب مسرف, croissance saine
Riche, léger et bien drainé => terre fertile, terreau, terre aérée, terre facile, productive, terba ghniya, تراب غني, terba khfifa, تراب خفيف, terba mssarfa, تراب مسرف, croissance saine
Humide, bien drainé et riche => terre fraîche, terreau, terre fertile, terre aérée, ne s'assèche pas, terba fziga, تراب فزك, terba ghniya, تراب غني, terba mssarfa, تراب مسرف, croissance vigoureuse, pourriture racinaire
Riche, humide, bien drainé => terre fraîche, terreau, terre fertile, terre aérée, ne s'assèche pas, terba fziga, تراب فزك, terba ghniya, تراب غني, terba mssarfa, تراب مسرف, croissance vigoureuse, pourriture racinaire
Sols légers, bien drainés, même pauvres, et supporte les sols calcaires. => adaptable, polyvalent, terre facile, terre aérée, terre méditerranéenne, terre maigre, terba khfifa, تراب خفيف, terba mssarfa, تراب مسرف, terba na9sa, تراب ناقص, terba kayssa, تراب قايس, tolérance, robustesse
Riche, bien drainé, légèrement acide => terre fertile, terreau, terre aérée, terre non calcaire, terre de bruyère, terba ghniya, تراب غني, terba mssarfa, تراب مسرف, terba 7amda, تراب حامض, croissance saine, jaunissement
Bien drainé, Riche, Argilo-calcaire => terre fertile, terreau, terre aérée, terre lourde mais filtrante, terre méditerranéenne, terba mssarfa, تراب مسرف, terba ghniya, تراب غني, terba tiliya, تراب طيني, terba kayssa, تراب قايس, croissance saine, chlorose