# --- Source: Le Drainage et l'Aération du Sol.pdf ---
drainage => évacuation d'eau, infiltration, tsarrof dial l'ard
aération du sol => circulation d'air, oxygénation, pores, thwiyya dial l'ard, l'hawa f traba
respiration racinaire => absorption d'oxygène, production d'ATP, tnfous l'jdor
asphyxie racinaire => racines noyées, suffocation, manque d'O₂, khna9 l'jdor, l'jdor mato blma ; symptômes: flétrissement, jaunissement, mort
eau stagnante => flaques persistantes, humidité excessive, lma kayw9ef, lma mjamme3 ; symptôme de mauvais drainage
odeur de pourriture (sol) => fermentation anaérobie, œufs pourris, méthane, rri7a khanza, rri7a dial lbaid lkhayeb ; signal d'asphyxie avancée
flétrissement paradoxal => feuilles jaunissent/flétrissent en sol mouillé, plante meurt de soif au milieu de l'eau, dbalan m3a lma, wra9 kaysefro wakha lma kayen
substrat drainant => terreau allégé, sable grossier, pouzzolane, perlite, gravier, térra khfifa, rraml l'ghlid, térra mkhallta
plantes méditerranéennes => Thym, Romarin, Lavande, Origan, za3tar, azir, khzama ; exigent drainage parfait, sol sec
succulentes et cactus => xérophytes, nabtat choki, sabr ; besoin d'un drainage absolu
pourriture du collet => maladie fongique, Pythium, Phytophthora, ramollissement de la tige, 3ffounia dial l'3na9, ghmal l'3anq ; mycotoxines, rend impropre
cache-pot (erreur) => pot sans trou, soucoupe non vidée, kas diyaf l'ma, tassila 3amra ; piège mortel, eau stagnante
sol argileux lourd => terre compacte, imperméable, térra 7arsha, traba qas7a, semelle de labour ; pire substrat
plantation sur butte => ados, monticule, surélevée, ghabta, tal3a dial l'ard ; améliore drainage et aération
trou de drainage => orifice d'évacuation, fond de pot percé, tqab dial l'pot, fou9iya ; obligation absolue, sans trou = mort
# --- Source: Plantation.pdf ---
culture en pleine terre => gherssa f l'ard, ard khalia, espace illimité, croissance maximale, moins d'arrosage
culture en pot => gherssa f mahba9, gamila, volume limité, besoin d'arrosage fréquent, plantes d'intérieur
volume racinaire => jdour, espace limité, racines qui tournent en rond, croissance ralentie, pot trop petit
autonomie hydrique => ma skaya, jedra katjib lma men lteht, résistance sécheresse, olivier adulte, arrosage bi-hebdomadaire en pot
inertie thermique => sol tampon, jdour mhamia, brûlure des racines l'été, gel du substrat l'hiver, températures stables
mobilité (des plantes en pot) => tḥarrek nbat, mnin tji chams, rentrer l'hiver, espèces gélives, changer de place
contrôle du substrat => trab dyal nbat, khalt mkhayer, acidité, drainage, sols calcaires ou argileux inadaptés
trempage de la motte => fa99a3a, tarf dyal trab, bulles d'air, réhydratation obligatoire, motte sèche imperméable
collet (de la plante) => rass l'gherssa, point de jonction, ne pas enterrer, pourriture du tronc, maladies cryptogamiques
plantes envahissantes => menthe, nna3na3, rhizomes traçants, kayntashar bzzaf, étouffement des cultures, pot enterré
distances de plantation => taba3d bin nbat, compétition lumière, compétition eau, maladies fongiques, oïdium, mildiou, nbat mdya9
pralinage => pralin, boue crémeuse, bouse de vache, jdour 3eryana, taux de reprise, maintien humidité racines
plantation automnale => wa9t kharif, Sainte-Catherine, dormance aérienne, racines continuent de croître, enracinement hivernal
brûlure chimique (des racines) => smida qwiya, engrais minéral concentré, choc osmotique, racines délicates, ne pas mélanger directement
effet pot de fleur (parois lissées) => 7ayt mless, bêche, racines tournent en spirale, ne colonise pas le sol, griffer les parois
# --- Source: Arrosage.pdf ---
arrosage => irrigation, gestion hydrique, sa9i (سقي), tes9iya (تسقية)
déficit hydrique => sous-arrosage, manque d'eau, 3tash (عطش), flétrissement (symptôme), feuilles jaunes (symptôme), croissance lente (symptôme)
excès d'eau => sur-arrosage, asphyxie racinaire, gher9ane (غرقان), pourriture racinaire (symptôme), jaunissement généralisé (symptôme), odeur de moisi (symptôme)
photosynthèse => production d'énergie, chlorophylle, nbat kayakol b shms (النبات كياكل بالشمس)
turgescence cellulaire => maintien du port, rigidité cellulaire, wakfa (واقفة), na9sa men lma katdoubal (ناقصة من الماء كدوبال, faute courante)
évapotranspiration => transpiration, pertes d'eau, cherki (شركي, vent desséchant), tabkhir lma (تبخير الماء)
réserve utile du sol => capacité au champ, point de flétrissement permanent, disponibilité en eau, qiyass lma f l'ard (قياس الماء في الأرض)
stress hydrique => sécheresse, déséquilibre hydrique, na9s lma (ناقص الماء), drouba (ضروبة, causée par le stress)
plantes aromatiques => menthe, thym, romarin, na3na3 (نعناع), za3tar (زعتر), rozmari (روزماري), huiles essentielles
plantes médicinales => absinthe, mauve, verveine, chiba (شيبة), fenugrec, métabolites secondaires
arganier => Argania spinosa, شجر أركان (shjar argan), l'argane (الأركان), adapté à l'aridité
goutte-à-goutte => irrigation localisée, économie d'eau, taqṭīr (تقطير), ghoṭṭa ghoṭṭa (غوطة غوطة), efficience élevée
type de sol => argileux, sableux, drainage, l'ard (الأرض), ghaba (غابة), influence des quantités d'eau
moment d'arrosage => tôt le matin, en soirée, éviter plein soleil (faute courante), tss9i bkri (تسقي بكري), tss9i f l3chiya (تسقي في العشية)
paillage => mulch, couverture du sol, conservation d'humidité, tadghiya (تدغية), tghliif l'ard (تغليف الأرض)
# --- Source: L'Humidité Ambiante.pdf ---
hygrométrie => mesure de l'humidité, Humidité Relative, HR, Rtouba dyal l'jou
humidité relative => HR%, taux d'humidité, Rtouba f'l'hawa, (faute courante : humidité absolue)
stomates => micropores, pores foliaires, fomm l'wra9, (symptôme lié : fermeture en air sec, ouverture en air humide)
transpiration foliaire => perte d'eau par les feuilles, évaporation végétale, tneshim dyal nbat, (faute courante : transpiration simple)
stress hydrique => manque d'eau, souffrance végétale, nbat 3tchan, (symptôme : bords bruns, pointes sèches, nécrose)
plantes hygrophytes => plantes tropicales, plantes d'humidité, nbat dyal lblays l'mwa7lin, (symptôme : feuilles larges et fines, bruni des feuilles en air sec)
plantes xérophytes => plantes désertiques, résistantes à la sécheresse, nbat dyal shra, kay9der 3la l3tash
arganier => Argania spinosa, arbre d'Argan, Argan, (adaptation : cuticule cireuse épaisse, système racinaire profond)
hygromètre => capteur d'humidité, appareil de mesure, appareil dyal rtouba, mizan l'rtouba
ventilation => aération, circulation d'air, thwiya, (faute courante : air stagnant)
brumisation => vaporisation d'eau, pulvérisation, ndiro lma bzif, رشٌّ
lit de billes d'argile => billes d'argile sous le pot, soucoupe humidifiée, t7t l'mrajel b l'kra, boules d'argile
maladies cryptogamiques => maladies fongiques, champignons, lmrad dyal nbat, ghmoula
oïdium => feutrage blanc, moisissure blanche, gha bida, l'ghbourya
botrytis cinerea => pourriture grise, moisissure grise, ghmoula remadiya, lmrad dyal l'fsad
# --- Source: Luminosité .pdf ---
photosynthèse => énergie chimique, glucides, chlorophylle, nbat kayakol (plante qui mange), تركيب ضوئي
chloroplastes => cellules végétales, usine à énergie, siège de la photosynthèse
chlorophylle => pigment vert, capture lumière, يخضور, خضورة
spectre lumineux => longueurs d'onde, couleurs, bleu, rouge, vert, phytochromes
intensité lumineuse => lux, PAR, µmol/m²/s, الشدة, ضو قاصح/قليل
photopériode => durée d'éclairement, jours longs/courts, floraison, مدة الضو
plantes héliophiles => plein soleil, (>20 000 lux), chams, ضو بزاف, thym, romarin, arganier
plantes sciaphiles => faible lumière, (<5 000 lux), ombre, ضو قليل, aspidistra, zamioculcas
arganier => Argania spinosa, Maroc, huile d'argan, fructification, شجرة الأركان, زيت أركان
lumière artificielle => lampes de croissance, LED, spectre complet, 2700K/6500K, ضو صناعي
manque de lumière (stress) => étiolement, tiges grêles, feuilles pâles, perte panachure, floraison inhibée, ضو ناقص, نبات كيتجبد
excès de lumière (stress) => brûlures foliaires, jaunissement, photo-oxydation, feuilles cassantes, ضو زايد, نبات محروق
acclimatation => transition progressive, adaptation, choc lumineux fatal (erreur), تعويد, نقل مفاجئ
luxmètre / mesure lumière => PAR, spectroradiomètre, capteur quantum, application smartphone, مقياس الضو
bonnes pratiques => nettoyer feuilles/vitrages, rotations, réflecteurs, fertilisation adaptée, adaptation progressive
# --- Source: Le Rempotage et le Surfaçage des Plantes.pdf ---
rempotage => empotage, changement de pot, transplantation, ne9l lghrassa, tghiras
substrat => terreau, mélange de culture, terre de pot, trab, trab dyal l'ghras
surfaçage => terreautage, renouvellement superficiel, ajout de terreau enrichi, tbdel trab lfou9ani
racines => chignon racinaire, radicelles, système racinaire, jdour, 3rou9
contenant => pot, bac, jardinière, ma9la, gamarra
drainage => trous de drainage, couche drainante, écoulement de l'eau, tqab dyal lma, tsraf lma
épuisement du substrat => appauvrissement, dégradation du terreau, carence nutritionnelle, trab safi, trab khawi
collet => zone de transition tige/racines, base de la plante, 3onq nbat
terre de jardin pure => terre de pleine terre, terre argileuse, trab dyal l'jardian, trab dyal l'ard
hygiène du pot => nettoyage, désinfection du contenant, n9a dyal lma9la, ta39im
croissance stoppée => arrêt de développement, stagnation, nmo twaqaf, nfa9s
jaunissement du feuillage => chlorose, feuilles jaunes, wrak sfar, sfirouriya
période idéale de rempotage => moment optimal, saison appropriée, waqt lghras, rabii3, khariif
engrais => fertilisation, nutriments, smad, ghbar
soins post-rempotage => mise au repos, période d'adaptation, ra7a mor tghiras, tkalim
# --- Source: Propagation et Reproduction Végétale.pdf ---
propagation végétale => Multiplication végétale, génération de plantes, تكاثر نباتي (takattour nabaati), زرّيعة (zerri3a)
reproduction sexuée (semis) => Production de graines, variabilité génétique, زراعة بالزرّيعة (zra3a b zerri3a), بذر (bithr), non-levée des graines, fonte des semis
reproduction asexuée (végétative) => Clonage, multiplication végétative, تكاثر خضري (takattour khadari), غرس (ghars), pourriture de la bouture, dessèchement
graine => Semence, embryon, زرّيعة (zerri3a), حبّ (7ebb), non-germination
clone => Génotype identique, fidélité des caractéristiques, نفس النوع (nofss n-naw3), مستنسخ (moustansakh)
diversité génétique => Variabilité, mélange génétique, تنوع وراثي (tanawo3 wiraati), اختلاف ديال النوع (ikhtilaf dyal n-naw3), descendance non fidèle à la plante mère
bouturage => Coupures, reproduction par fragment, غراسة (gherassa), عود (3oud), bouture qui ne prend pas (ma chadatch - ما شداتش), pourriture, dessèchement
marcottage => Marcottage aérien, enracinement sur plante mère, ترقيد (taryid), تخريز (tekhriz), non-enracinement (ma daratch jdor - ما دارتش جذور), moisissure
division => Séparation de touffes, rajeunissement, تقسيم (taqssim), تفرق (tferriq), section sans bourgeons ou racines
greffe / porte-greffe => Union végétale, تلقيم (tal9im), ساق الأصل (saq l-asal), greffe qui ne prend pas (ma chadatch - ما شداتش), rejet du porte-greffe
racines adventives => Néo-racines, formation de racines sur tige/feuille/racine, جذور جديدة (jdor jdida), جذور الغرسة (jdor lgherssa), absence de formation
hormone d'enracinement => Auxine, stimulateur de racines, هرمون التجذير (hormone t-tajdir), دويرة ديال الغرسة (dwira dyal lgherssa), dosage excessif (hreqt lgherssa - حرقت الغرسة)
substrat => Milieu de culture, terreau, mélange, تراب الغرس (ttrab l-ghars), خليط (khalit), mal drainé, trop compact, asphyxie racinaire
humidité => Hydrométrie, eau, رطوبة (rtouba), الماء (l-ma), excès d'eau (lma bzaf - الماء بزاف), dessèchement (kar7at - كرحات)
stérilité / désinfection => Propreté, asepsie, تعقيم (ta3qim), نظافة (ndafa), maladies fongiques (ghmolt - غمولت), pourriture (khnazt - خنازت), fonte des semis (dboulya - ذبولية)
# --- Source: Taille et Élagage Végétal.pdf ---
taille => T9ṣiṣ, Ta9ṣiṣ, coupe, l'ébranchage
élagage => Tqti3 chjar kbar, tqti3 l-khchan, débranchement, coupes grosses branches
santé de la plante => Seḥet nbat, prévention maladies, circulation air, l-merḍ dial chjar
floraison/fructification => Tzhar, t3ti l-ghalla, thmar, production, stimulation
outils de taille => M9eṣ, menchar, cisaille, sécateur, tronçonneuse, outils dial t9ṣiṣ
hygiène de coupe => Nḍafa, t399im, désinfection, transmission pathogènes, chancres, virus
périodicité de taille => Waqt t9ṣiṣ, timing, saison, dormance, ghalat f l-waqt (erreur de période), gel intense
technique des 3 coupes => Tqti3 l-khchan b 3 marrat, sous-coupe, coupe de dessus, coupe finale, déchirure écorce (symptôme)
taille excessive (topping) => Tqṣiṣ bzzaf, tqti3 l-fوقani, surtaille, stress, affaiblissement, rapport racine/feuillage perturbé
gourmands => L-msafer, rejets, pousses faibles, pousse anarchique, rjou3
cicatrisation => Tdaoui, skran, guérison, fermeture de plaie, coupe nette, plaies ouvertes (symptôme)
col de la branche => 3onq l-ghṣen, tfarwiḥa, collet, renflement, stubs (faute courante)
bois mort/malade => L-3oud l-mayyet, l-3oud l-merḍ, branches pourries, propagation pathogènes
mastic de cicatrisation => Dwa dyal t9ti3, pâte à cicatriser, kay7bes l-l-rtouba (piège l'humidité), kayzid l-khnaz (favorise pourriture), pas bénéfique
olivier => Zitoun, Olea europaea, arbre fruitier méditerranéen, taille de fructification, alternance (problème à résoudre)
# --- Source: Origine Géographique et Biomes.pdf ---
origine géographique d'une plante => aire biogéographique, dar dyal nbat (maison de la plante)
biome => grande unité écologique, zone climatique, mantiqa dyal jow w nbat (zone de climat et végétation), erreur: climate seul n'est pas un biome
climat => température, précipitations, jow, sbab l'khela (cause de la stérilité, si mauvais climat)
adaptation => évolution, tolérance, t'aloum, welfet (s'est habituée), ma katmoutch b sahel (ne meurt pas facilement)
contraintes environnementales => stress hydrique, basses températures, mouchkil dyal l'environnement, l'3tache (la soif), lberd bezzaf (le froid excessif)
horticulture => jardinage, culture ornementale, l'ghers dyal zhour (culture des fleurs), zer3 dyal zina (culture pour la beauté)
agriculture => production alimentaire, fella7a, zer3 dyal lmekla (culture pour la nourriture), l'khessara (perte, si mauvaises pratiques)
xérophytisme => adaptation à la sécheresse, résistance à la soif, m'welfa b l'3tache (habituée à la soif), ma katsorbch lma bezzaf (ne boit pas beaucoup d'eau)
succulence => stockage d'eau, plantes grasses, mkhazna lma (qui stocke l'eau), nbat ghliid (plante grasse), l'kaktus
feuilles coriaces / sclérophylles => feuilles dures, épaisses, wara9 9ase7 (feuilles dures), makaykhessrouch b'sakhana (ne s'abîment pas avec la chaleur)
racines profondes => accès nappe phréatique, jdor ghara9a (racines profondes), katchreb men taht l'ard (boit d'en dessous de la terre)
vernalisation => besoin de froid pour floraison, cycle hivernal, bard bach tkhroj zhar (froid pour faire sortir la fleur), ma kayfettahch (ne fleurit pas) si pas de froid
huiles essentielles => mécanismes anti-transpirants, arômes, zit 3atri (huile aromatique), ri7a mjahda (odeur forte)
drainage du sol => sol perméable, évacuation de l'eau, l'ard katkhrej lma (terre qui sort l'eau), l'ma kaywgel (l'eau stagne - mauvaise situation)
écotypes locaux => variétés indigènes, plantes endémiques, nbat beldi (plante locale), m'welfa b ardha (habituée à sa terre), makatmerdch (ne tombe pas malade facilement)
# --- Source: pH du Sol .pdf ---
ph du sol => Potentiel Hydrogène, acidité du sol, basicité du sol, taux d'acidité, `PH dial l'ard`
sol acide => terre acide, pH faible, riche en ions H+, `ard 7amda`, toxicité aluminium, carences Phosphore/Calcium/Magnésium
sol alcalin => sol basique, terre calcaire, pH élevé, riche en ions OH-, `ard 9a3idiya`, `ard kalkiria`, `l'ard lmal7a` (faute courante : terre salée)
disponibilité des nutriments => assimilabilité, absorption des minéraux, `wjouhd dial l'ghida` (disponibilité de la nourriture), facteur limitant invisible, carences
chlorose ferrique => carence en fer, jaunissement des jeunes feuilles (avec nervures vertes), `sfoura dial lwra9` (des jeunes feuilles), `mrad l7did`
plantes acidophiles => plantes de terre de bruyère, amantes de l'acidité, `nbať kay7ma9 3la l'7amdiya`, chlorose ferrique sévère (en sol calcaire)
plantes calcicoles => plantes alcalines, plantes de sol calcaire, amantes du calcaire, `nbať kay3jbou l'kalker`, acidifient leur rhizosphère
ajuster le ph => corriger le pH, modifier le pH, réguler le pH, `n9ad l'ard`, progressivité impérative, analyses de contrôle
acidifier le sol => abaisser le pH, réduire le pH, rendre le sol plus acide, `n7ammdou l'ard`, soufre élémentaire, terre de bruyère, tourbe blonde
alcaliniser le sol => augmenter le pH, chaulage, rendre le sol plus basique, `n9alwnou l'ard`, chaux, calcaire broyé, cendres de bois, coquilles d'œufs
plantes bio-indicatrices => indicateurs naturels de pH, flore indicative, `nbať kaywerrina PH`, bruyères (acide), coquelicots (alcalin), trèfles (neutre)
macronutriments => Azote, Phosphore, Potassium, Calcium, Magnésium, éléments essentiels, `ghida kbira dial l'nbať`
oligoéléments => Fer, Manganèse, Zinc, Cuivre, Aluminium, éléments traces, `ghida sghira dial l'nbať`, blocage nutritionnel
arganier => arbre d'Argan, `arjân`, `awrag`, tolérance exceptionnelle (pH 7.5-8.5), sols calcaires arides marocains
sols marocains => `ard maghribiya`, dominante calcaire (plaines : pH 7.5-8.5), sols plus acides (montagnes forestières : pH 5.5-6.5), adaptation des plantes indigènes
# --- Source: Croissance et Développement.pdf ---
croissance => augmentation de taille, volume, masse, kaykber, l-kbour
développement => maturation, évolution, stades phénologiques, nmow, ttatwar
germination => réactivation métabolique, émergence plantule, tanbot, n-nbeta
croissance végétative => phase végétative, biomasse, n-nmou l-khdari, l-khella
floraison => antèse, initiation florale, stade reproducteur, tezhir, l-ward, chute de fleurs
fructification => maturation des fruits, grossissement de l'ovaire, ttmar, kaydir t-tmar, chute de jeunes fruits, Blossom End Rot
nutriments => éléments minéraux, engrais, l-ghidha', smad, carence, excès
eau => humidité, irrigation, l-ma, saqi, l-3tach, stress hydrique
lumière => soleil, irradiation, photopériode, d-daw, sh-shems, croissance étiolée
température => chaleur, froid, conditions thermiques, l-harara, s-skhouna, l-berd, croissance ralentie
azote (n) => N, Azote, chlorose (vieilles feuilles), croissance ralentie
phosphore (p) => P, Phosphore, mauvaise floraison, faible viabilité du pollen
potassium (k) => K, Potassium, nécrose (bords des feuilles), chute de fruits, qualité faible des fruits
chlorose => jaunissement du feuillage, feuilles jaunes, s-sfourya d-l-weraq
facteurs limitants => stress abiotiques, loi du minimum de Liebig, l-3amil l-mouhaddid, naqs
# --- Source: Types de Sol.pdf ---
sol => terre, turbat, trab, l-ard, terreau (faute courante : confusion sol naturel/terreau en pot)
texture du sol => granulométrie, argile, limon, sable, ṭin, reml, kaylṣeq wla ḥerch
structure du sol => agrégats, porosité, aération, l-ard mfertta, l-ard mqassaḥa (symptôme : sol tassé, difficulté pour les racines)
complexe argilo-humique (cah) => fertilité chimique, CEC, humus, argile, l-makla dyal nbat, lessivage (symptôme : carences malgré engrais)
rétention d'eau / réserve utile (ru) => capacité hydrique, humidité, lma, kayched l-ma, kaychaf bzzaf (symptôme : plante flétrie, arrosages fréquents)
drainage / anoxie racinaire => évacuation de l'eau, aération, l-ma kaydouz, l-ma kaywaqef, pourriture (symptôme : racines noires, odeur fétide, jaunissement des feuilles)
sol argileux => sol lourd, collant, compact, ṭin, ard ṭiniya, kaylṣeq bzzaf (symptôme : engorgement, fissures au séchage, travail difficile)
sol sableux => sol léger, friable, perméable, reml, ard remliya, kaychrab l-ma dghya, mṣayaf (symptôme : arrosages très fréquents, lessivage rapide)
sol limoneux / battance => équilibre, fragile, croûte de surface, ard rṭeb, kaytcherreh, qchra (symptôme : semis ne lèvent pas, eau ruisselle)
sol humifère => sol organique, richesse en humus, ard mkhallṭa, ard dyal l-ghaba, ghniya (symptôme : acidité parfois excessive, minéralisation rapide)
ph du sol => acidité, alcalinité, calcaire, ḥamḍa, malḥa (souvent utilisé pour calcaire/alcalin), l-ard ma mwalmach (symptôme : carences spécifiques, chlorose)
amendement du sol => amélioration, modification, ziyada l-l-ard, nṣawb l-ard, ngheddi l-ard (faute courante : confondre amendement et engrais)
substrat de culture => terreau, mélange, support, t-turba dyal l-maḥbes, l-khallat, d-dabigh (faute courante : utiliser terre de jardin pure en pot)
hydroponie => culture hors-sol, sans terre, zra3 bla trab, nabaat f l-ma, système dyal l-ma (symptôme : nécessite un contrôle strict pH/EC)
pourriture racinaire / maladies telluriques => racines pourries, asphyxie, champignon, jdor khassrin, l-nabat kaytkhnaq, Pythium (symptôme : flétrissement malgré l'eau, tige molle à la base)
# --- Source: Nutrition Végétale et les Engrais.pdf ---
nutrition végétale => Alimentation minérale, plantes autotrophes, تغذية النباتات (taghdiyat n-nabatat), ma kta kta n-nabat
n.p.k. => Macroéléments majeurs, engrais composés, أسمدة مركبة (asmida morakaba), ghbar dial l-khdra
azote (n) => Croissance végétative, masse verte, feuillage abondant, N. Carence: jaunissement feuilles basses, croissance stoppée. Excès: feuilles aqueuses, sensibilité maladies.
phosphore (p) => Système racinaire, enracinement, division cellulaire, transfert énergétique, P. Carence: développement racinaire déficient, vulnérabilité accrue.
potassium (k) => Régulateur physiologique, floraison, fructification, résistance, qualité gustative, K. Carence: floraison faible/absente, fruits petits/déformés, nécrose bords feuilles.
oligo-éléments => Micronutriments, éléments vitaux, Fer, Magnésium, Calcium, Soufre, عناصر صغرى (anasir soghra), l-ghbar sghir
engrais organiques => Compost, fumier, purin d'ortie, action lente, amendement sol, ghbar tabi3i (natural fertilizer), khamej mzyan
engrais minéraux => Engrais chimiques, granulés, sels minéraux, action rapide, ghbar kimawi (chemical fertilizer), l-kima, l-ghbar l-msna3
carence => Manque d'éléments nutritifs, déficit, faim de la plante, نقص (na9s), joo3 n-nabat
sur-fertilisation => Excès d'engrais, surdosage, brûlure des racines, plasmolyse osmotique, زياد فالغبار (ziyad f l-ghbar), 7ra9 l-jdor. Symptôme: bouts de feuilles grillés, dépôts de sels, flétrissement.
chlorose ferrique => Carence en Fer, jaunissement internervaire des jeunes feuilles, nervures vertes, sols calcaires, sfourya dial l-weraq, mard l-7did
compost => Matière organique décomposée, amendement sol, compostage, كومبوست (kompost), dbal, khamej dial l-ard
période de croissance active => Fertilisation, printemps à fin d'été, phase d'absorption intense, waqt n-nomow (growth time), l-waqt dyal l-kbra. Faute: fertilisation en repos végétatif.
racines => Système racinaire, puiser les nutriments, ancrage, l-jdor (the roots), jdour
chlorophylle => Pigment vert, synthèse de la chlorophylle, photosynthèse, yakdour l-akhdar (the green color/pigment), sabgha khadra
# --- Source: Parasites Courants.pdf ---
ravageurs végétaux => parasites, organismes nuisibles, pestes, ddoud, hacharat dayra ddarr, l'ghbar
organismes piqueurs-suceurs => suceurs de sève, hacharat katmouss l'3ssir dyal nbat, affaiblissement, jaunissement (chlorose)
pucerons (aphids) => man, l'mana, ddoud lkhder, déformation du feuillage, miellat, fumagine, vecteurs de virus
cochenilles (mealybugs / scale insects) => l'gorn, ddoud lbyed, l'koten, amas cotonneux, carapaces dures, jaunissement, affaiblissement
araignées rouges (tetranychus urticae) => acariens, l'3ankabout l7mer, tighbari, taches chlorotiques, toiles soyeuses, chaleur, faible humidité
miellat => substance sucrée, liquide collant, l'3ssel dyal l'man, ssoukar dyal l'hacharat, l'fasskha, brillant, collant
fumagine => champignon noir, moisissure noire, k7oulia, l'ghrab, l'm3affen, réduit la photosynthèse
dommages aux plantes => affaiblissement, perte de rendement, déformation, jaunissement (chlorose), maladies virales/bactériennes, esthétiques, physiologiques, sanitaires
photosynthèse => production d'énergie, tarkib daw'i, nbat kaytsawwer b'chams, makla dyal nbat, processus vital
détection précoce des ravageurs => surveillance, diagnostic rapide, mra9aba, t9elleb 3la l'merd, inspection visuelle, pièges collants
lutte intégrée contre les ravageurs (ipm) => gestion intégrée des nuisibles, tadbire chamil dyal l'afaat, tari9a kamla, équilibre écologique
contrôle biologique => utilisation d'ennemis naturels, biocontrôle, l'm3alaja b'ddoud lli kayakul ddoud, s7ab nbat, insectes auxiliaires, acariens prédateurs, biopesticides
insectes auxiliaires => insectes prédateurs, ennemis naturels, hacharat sadi9a, ddoud lli kay3awen, mol kherouf (coccinelle), Macrolophus, Coccinelles, Chrysopes
lutte chimique => insecticides, pesticides, traitements chimiques, dwaw, ras, chimiya, l'ghobra, dernier recours, sélectivité, rotation, résistance
transmission de maladies (virales/bactériennes) => vecteur de virus, pathogènes, infections, mradh dyal nbat, l'virus, l'mikrob, l'3doua, Aleurodes, pucerons
# --- Source: Cycle de Vie.pdf ---
cycle de vie végétal => دورة حياة النبات, dawrat ḥayat n-nabat, مراحل نمو النبتة, la vie d'une plante
germination => إنبات, inbat, نبيت, فقصان, خروج النبتة من الزريعة
propagation végétative => تكاثر خضري, takāthur khaḍari, غرس, عقلة, شتلة, تشتيل
plantes annuelles => حَوْلِيَّة, ḥawliya, نباتات حولية, نبتة ديال عام, زريعة ديال كُلّْ عام, كتموت من بعد ما كتولد
plantes bisannuelles => ثنائية الحول, thunā'iyat al-ḥawl, نباتات ثنائية الحول, نبتة ديال عامين, كتعيش عام وكتولد العام الثاني
plantes vivaces (herbacées) => مُعَمِّرة, mu3ammira, نباتات معمرة, كترجع كل عام, كتعيش بزاف
arbustes et arbres (vivaces ligneuses) => شجيرات وأشجار, chujayrāt w achjār, نبتة عودية, كيعيشو بزاف د السنين, شجر
implications culturales => تدبير زراعي, tadbir zirā3i, تسيير الفلاحة, كيفاش نخدمو الأرض, تقنيات الزراعة
vernalisation => تبريد, tabrīd, حاجة للبرد, خاصها البرد باش تزهر, صدمة البرد
rotation des cultures => دورة زراعية, dawra zirā3iya, تناوب المحاصيل, تبديل الغرس, ما نزرعوش نفس الحاجة كل عام
maladies et ravageurs => أمراض وآفات, amrāḍ w āfāt, حشرات, دودة, فطريات, مرض ديال الزرع, العدو ديال النبتة
fertilité du sol => خصوبة التربة, khuṣūbat at-turba, أرض خصبة, أرض صالحة للزراعة, أرض فيها الخير
taille et élagage => تقليم, taqlīm, تقشاب, تنقية الشجر, قصان الأغصان
porte-greffe => حامل الطعم, ḥāmil aṭ-ṭa3m, الأصل, الشجرة الأصلية, نبتة الأم, الكاية
arganier (argania spinosa) => أركان, argan, شجرة أركان, زيت أركان, اللوز ديال أركان, شجر الصبر
# --- Source: Technologies Horticoles Modernes.pdf ---
technologies horticoles modernes (agtech) => Fellaha 3asriya, teqniyat nbat jdida, l'AgTech, technologie agricole
agriculture de précision => Fellaha d d9i9a, l'agriculture intelligente, gestion fine, optimisation
intrants => Moudakhalat, li kan3tiw l'nbat, besoins des plantes, consommables
extrants => Mokharijat, li kanakhdo men nbat, produits finis, rendement, qualité
lampes led horticoles => Dow dial nbat, l'Ampoulat LED l'khasin b zra3a, lumière artificielle, économie d'énergie
spectres lumineux => Alwan d'ddow, couleurs de lumière, lumière bleue, lumière rouge, photosynthèse
photosynthèse => Binat daw'iya, nbat kayakol, fabrication de nourriture, chlorophylle
capteurs (monitoring) => Katchafat, capteurs, li kay9iss, mra9aba, collecte de données
humidité du sol => Rtouba dial l'ard, l'ma f l'ghras, l'ard nachfa (symptôme), sec, TDR/FDR
conductivité électrique (ec) => L'mlouha f l'ma, l'khrat f l'ma, EC, sur-fertilisation (symptôme), accumulation de sels
ph du substrat/solution => L'hmouda dial l'ard, pH, qays l'hmouda, assimilation des nutriments, nbat ma kaykberch mzyan (symptôme)
irrigation au goutte-à-goutte => Taqtir, goutte-à-goutte, l'ma b negta, tn9it, économie d'eau
cultures hors-sol => Zra3a bla trab, nbat f l'ma, hydroponie, aéroponie, système fermé
automatisation horticole => Makina dial l'ard, système automatique, control intelligent, domotique horticole
contraintes hydriques => 9ellat l'ma, ma kaynch l'ma, la sécheresse, l'3tach, régions arides
# --- Source: La Température et le Climat.pdf ---
température en botanique => facteur écologique, énergie cinétique, règle la physiologie. Darija: 7rara, skhouniya u berdouiya. Faute: Penser que toutes les plantes ont les mêmes optima sans considérer l'espèce.
activité enzymatique => optimum thermique, dénaturation, vitesse métabolique, catalyse. Darija: l-khedma dyal l-anizimat, l-khedma dyal l-khoubbiza. Faute: Ignorer la destruction irréversible des enzymes par chaleur excessive.
photosynthèse => RuBisCO, photo-inhibition, photorespiration, production de glucides. Darija: l-bnia d-dhawiya, tarkib d-dhaw'i. Faute: Croire que plus de lumière égale toujours plus de photosynthèse, sans considération thermique.
températures cardinales => Tmin, Topt, Tmax, seuils de croissance, survie. Darija: 7rara drouriya, 7rara moulay, 7rara l-7ad. Faute: Confondre Topt avec la température de survie maximale.
rusticité => tolérance au froid, plantes gélives, cryoprotecteurs, zones USDA. Darija: sbara 3la l-berd, qawiya 3la t-telj. Symptômes: éclatement des membranes, nécrose. Faute: Planter des espèces non-rustiques dans des zones à gelées.
vernalisation => besoin de froid prolongé, déclenchement floraison, synchronisation printanière. Darija: l-berd dyal azhar, t-tbarrad. Faute: Attendre une floraison sans période de froid adéquate.
thermotolérance => résistance à la chaleur, HSP, métabolisme CAM, xérophytes. Darija: sbara 3la s-skhouna, qawiya 3la s-sahed. Symptômes: évapotranspiration excessive, production de radicaux libres. Faute: Penser que toutes les plantes désertiques supportent l'eau en abondance.
thermopériodisme => amplitude jour/nuit, différentiel thermique, respiration nocturne, translocation des sucres. Darija: khtilaf d-dharajat bin n-nhar o l-lil. Faute: Maintenir une température constante jour et nuit en serre.
dormance hivernale => repos végétatif, ralentissement métabolique, survie hivernale, inhibition de croissance. Darija: n3as d-chta, s-skout d-l-khder. Faute: S'inquiéter d'une absence de croissance en hiver chez une espèce tempérée.
stress thermique (coup de froid) => flétrissement, noircissement foliaire, chlorose, coloration anthocyanique. Darija: derbet l-berd, t-barrad. Diagnostic: flétrissement non amélioré par arrosage. Faute: Confondre avec le manque d'eau et sur-arroser.
stress thermique (coup de chaud) => flétrissement brutal, brûlures marginales, blanchiment, enroulement foliaire. Darija: derbet s-smoum, sahed, t-cherwit b-skhouna. Diagnostic: brûlures sèches et croustillantes, apparition en après-midi caniculaire. Faute: Attribuer toutes les brûlures au soleil seul.
principes actifs (gestion thermique) => huiles essentielles, alcaloïdes, flavonoïdes, polyphénols, métabolites secondaires, stress hydrique modéré. Darija: ziout asassiya, dwayat d-l-3choub. Faute: Croire que le plus gros rendement en biomasse équivaut au plus de principes actifs.
arganier (adaptation marocaine) => tolérance 50°C / -3°C, dormance estivale, résilience climatique, Maroc. Darija: Argan, L-Argana. Faute: Sous-estimer l'adaptation exceptionnelle de l'arganier à des conditions extrêmes.
zones de rusticité (maroc) => USDA, microclimats, côtes (9-11), continental (9), montagnes (7-8). Darija: mnatiq d-tahammol d-l-berd, l-maqadir d-t-telj. Faute: Ignorer la variabilité climatique entre les régions marocaines.
méthodes de protection => voile d'hivernage, paillage, ombrage, bassinage, irrigation optimisée. Darija: l-7imaya, t-ghatya, d-del, r-raya7. Faute: Appliquer des méthodes inappropriées (ex: bassinage en plein soleil favorisant les brûlures).
# --- Source: Toxicité Végétale.pdf ---
toxicité végétale => capacité d'une plante à nuire, poison végétal, sma dial nbat, nbeet msemmem
parties toxiques d'une plante => feuilles, sève, fruits, racines, bois, graines, wara9, s-sira, l-fakya, l-gdor, l-3oud, z-zra3
voies d'exposition aux toxines => ingestion, contact cutané, inhalation, klan, 9yass l-jeld, ch-chm, l-mou9arraba (erreur fréquente : simple proximité)
substances toxiques végétales => composés chimiques, toxines, poison, glycosides cardiaques, ricine, oxalates de calcium, anthranoïdes, alcaloïdes tropaniques, s-sma, l-msemmem
effets d'une intoxication végétale => néfastes, irritation locale, troubles systémiques, mort, lésions, défaillances d'organes, d-darrar, l-khater, khayb
populations à risque élevé => enfants, animaux domestiques, chiens, chats, d-drari s-sghar, l-bhaym, l-klab, l-gtaṭ, kayaklo ay 7aja (comportement à risque)
symptômes d'intoxication => signes cliniques, manifestations, l-3alamat, l-mrad
troubles gastro-intestinaux => vomissements, diarrhée, douleurs abdominales, crampes, t9ya, isrhal, wja3 l-kersh, l-m3ida mkhallta (estomac perturbé)
irritations locales => gonflement (œdème), rougeur, douleur, sensation de brûlure, lésions buccales, nfikh, 7mira, wja3, l-7ri9, t9char l-fomm (peau du palais qui pèle)
troubles cardiovasculaires => arythmies, bradycardie, tachycardie, arrêt cardiaque, d9at l-9alb machi m9addin, l-9alb kaywa9f, boum boum bzzaf (battements trop rapides)
troubles neurologiques => tremblements, convulsions, faiblesse, désorientation, coma, délire, hallucinations, r-r3ida, t-tawassan, f9dan l-wa3i, kaykhawwad (désorienté)
services d'urgence / aide médicale => Centre Antipoison, vétérinaire, médecin, markaz d-dwa d-dsma, tabib, tabib l-bhaym, l-bouliss (services de secours)
premiers soins immédiats => retirer la source, rincer, appeler les secours, identification de la plante, l-awaliyat d-s-si3afat, 7iyad nbat, ghsel, 3ayyet l-bouliss, t-t9ya b-l-force (erreur : provoquer des vomissements)
prévention des intoxications => identification des plantes, séparation/protection, alternatives non-toxiques, l-wi9aya, t-t3araf 3la nbat, t-tba3id, nbaat ma fihch s-sma
plantes toxiques marocaines spécifiques => Laurier-rose (Nerium oleander), Aloe vera (latex), Datura (Datura stramonium), Arum commun (Arum italicum), dfla, s-sabbar, t-targa
# --- Source: Stress Hydrique _ Thermique _ Lumineux.pdf ---
stress végétal => perturbation externe, abiotique, d3f dial nbat, mrḍ nbat, stresse dyal lghers, altération productivité, survie menacée, flétrissement, jaunissement, nécrose, brûlures
stress hydrique => manque d'eau, sécheresse, excès d'eau, anoxie, 3tash nbat, na9s lma, ziada dyal lma, lghers m9tow3 3lih lma, lma bzaf, gher9 lghers, flétrissement, enroulement des feuilles, nécrose marginale, abscission, chlorose, stagnation croissance, pourriture racinaire
sécheresse => manque d'eau, déficit hydrique, aridité, ga7t, qillat lma, l3tash, nbat mechegreg, shih, nbat 3tchan, perte de turgescence, fermeture des stomates, flétrissement, enroulement des feuilles, nécrose marginale, abscission
excès d'eau (anoxie) => sol saturé, noyade racinaire, asphyxie, lma bzaf, nbat gher9an, tkhneq lghers, sa9i bzaf, jaunissement généralisé (chlorose), stagnation croissance, pourriture racinaire (molles et sombres)
stress thermique => froid, gel, chaleur, canicule, température extrême, skhouna bzaf, berd bzaf, ljelid, sma skhouna, nécrose jeunes pousses, gélivures, destruction bourgeons, brûlures, blanchiment, flétrissement passager
gel => basses températures, froid intense, congélation, ljelid, tlaj, berd 9ase7, endommagement membranes cellulaires, nécrose jeunes pousses, fissures écorce (gélivures), destruction bourgeons
canicule => chaleur intense, forte température, déshydratation, skhouna, ssihd, 7rara dyal smail, dénaturation protéines/enzymes, transpiration excessive, brûlures, blanchiment, flétrissement passager
stress lumineux => manque de lumière, excès de lumière, photo-oxydation, dlam bzaf, dou bzaf, chmiss 9awya, étiolément, pâleur des feuilles, brûlures sévères, perte de pigmentation
étiolément => manque de lumière, croissance anormale en hauteur, pâleur, nbat mtwel, mtawel, mjerboud, tiges minces et faibles, internœuds allongés, pâleur des feuilles
paillage (mulching) => couverture du sol, protection du sol, conservation d'humidité, taghtiyat l'ard, tghatti l'ard, ferch, plastique dial l'ard, réduction évaporation, modération température du sol
irrigation ciblée => goutte-à-goutte, micro-irrigation, économie d'eau, s9aya b tan9it, tan9it, lma b lkhat, nbch lma, minimise pertes, efficience de l'eau
capteurs d'humidité du sol => sondes tensiométriques, TDR, FDR, mesure d'eau du sol, machina dyal lma, mizan lma, sbirra dyal lma, aide à la décision d'irrigation
température foliaire => température de la feuille, indicateur de stress hydrique, skhounat lwra9, lwra9 skhonin, feuille stressée plus chaude
espèces xérophytes => plantes résistantes à la sécheresse, nbat sahoui, nbat kay9awem l3tash, lghers li mssaber, Thym, Romarin, Lavande, Arganier
arganier => Argania spinosa, arbre endémique, résistance à la sécheresse, Argan, Louz dial Sous, reboisement zones arides
# --- Source: Maladies Fongiques.pdf ---
maladies fongiques => Pathologies végétales, infections végétales, mrad nbat, marḍ l-nbat dial ghbar, tfungul, ḥafuna
agents pathogènes => Champignons pathogènes, Fungi, Oomycètes, microbes, ghbar, tfungul, fṭar
plante hôte => Végétal affecté, culture, nbat, šajara, ghras, ḍaḥiya, al-ʿāʾil
symptômes => Manifestations, signes, dégâts, ʿalamāt, mwāsem, nšāfa, ḥarāki (mouvements)
oïdium => Powdery Mildew, šib, ghbar byaḍ, ḥafuna byaḍ, poudre blanche (symptôme), taches blanches (faute courante)
mildiou => Downy Mildew, bzrouk, nwašaf, ḥafuna dial zit, taches huileuses (symptôme), feutrage gris (symptôme)
fusariose => Fusarium Wilt, dbol, ḍbol, mrad dial l-judor, flétrissement (symptôme), nécrose vasculaire (symptôme), l-kaḥoulia (pour la couleur brune interne)
botrytis => Pourriture Grise, ghbar rmadi, ḥafuna rmadi, tʿaffun, moisissure grise (symptôme), pourriture molle (symptôme), l-foun (faute courante pour moisissure)
humidité élevée => Eau libre, rosée, pluie, irrigation excessive, rṭouba, lma bzaf, nḍa, goutes d'eau (facteur favorisant)
aération => Circulation de l'air, ventilation, espacement, t-hwiya, hwawi, nqess men zḥam, riḥ (vent)
conditions climatiques => Température, humidité, climat, jaw, mnah, šrouṭ l-mnāḵh
stress de l'hôte => Vulnérabilité, affaiblissement, blessures mécaniques, carences nutritives, ḍaʿf nbat, mrad dial l-jraḥ
lutte intégrée (ipm) => Gestion intégrée, prévention, muḥaraba šamila, t-ḥafḍa l-muntadima, idāra mutakāmila
biocontrôle => Contrôle biologique, agents bénéfiques, produits naturels, muḥaraba ḥayawiya, dwa dial l-ḥayawān, l-bactiriya, l-fṭar l-mufid
fongicides => Traitements chimiques, produits phytosanitaires, dwa dial tfungul, muḥaraba kimyawiya, dwa kimyawi, poison (faute courante)